MODE 2
SIZE 11/70
LIMIT 0/1000
COLOR LIMIT 4
STARS 200/900/2000
POWERUPS 1/0/0/0
0 7 7 7 7 11 7 7 7 7 0
0 7 7 35 7 7 7 7 7 0 0
0 0 13 7 7 18 7 7 7 0 0
0 0 7 7 7 7 7 7 0 0 0
0 0 0 7 1 35 7 13 0 0 0
0 0 0 7 7 7 7 0 0 0 0
0 0 0 7 7 7 7 0 0 0 0
0 7 7 2 7 7 7 7 7 7 0
0 7 7 7 0 35 0 7 7 7 0
0 13 7 7 7 7 7 7 7 7 0
0 0 7 6 7 15 35 7 13 7 0
0 0 7 7 7 7 7 7 7 7 0
0 0 0 19 7 7 19 7 7 0 0
0 0 0 7 7 7 7 7 0 0 0
7 7 7 7 7 35 7 7 7 7 7
7 7 7 7 7 7 3 7 7 7 0
0 7 16 7 7 35 7 7 15 7 7
0 7 7 7 19 7 7 7 7 7 0
0 0 7 7 7 7 7 7 7 7 0
0 0 11 7 7 7 7 7 19 7 0
0 0 0 0 0 0 0 0 0 0 0
0 0 0 0 0 0 0 0 0 0 0
0 0 0 0 0 0 0 0 0 0 0
0 0 0 0 0 0 0 0 0 0 0
0 0 0 0 0 0 0 0 0 0 0
0 0 0 0 0 0 0 0 0 0 0
0 0 0 0 0 0 0 0 0 0 0
0 0 0 0 0 0 0 0 0 0 0
0 0 0 0 0 0 0 0 0 0 0
0 0 0 0 0 0 0 0 0 0 0
0 0 0 0 0 0 0 0 0 0 0
0 0 0 0 0 0 0 0 0 0 0
0 0 0 0 0 0 0 0 0 0 0
0 0 0 0 0 0 0 0 0 0 0
0 0 0 0 0 0 0 0 0 0 0
0 0 0 0 0 0 0 0 0 0 0
0 0 0 0 0 0 0 0 0 0 0
0 0 0 0 0 0 0 0 0 0 0
0 0 0 0 0 0 0 0 0 0 0
0 0 0 0 0 0 0 0 0 0 0
0 0 0 0 0 0 0 0 0 0 0
0 0 0 0 0 0 0 0 0 0 0
0 0 0 0 0 0 0 0 0 0 0
0 0 0 0 0 0 0 0 0 0 0
0 0 0 0 0 0 0 0 0 0 0
0 0 0 0 0 0 0 0 0 0 0
0 0 0 0 0 0 0 0 0 0 0
0 0 0 0 0 0 0 0 0 0 0
0 0 0 0 0 0 0 0 0 0 0
0 0 0 0 0 0 0 0 0 0 0
0 0 0 0 0 0 0 0 0 0 0
0 0 0 0 0 0 0 0 0 0 0
0 0 0 0 0 0 0 0 0 0 0
0 0 0 0 0 0 0 0 0 0 0
0 0 0 0 0 0 0 0 0 0 0
0 0 0 0 0 0 0 0 0 0 0
0 0 0 0 0 0 0 0 0 0 0
0 0 0 0 0 0 0 0 0 0 0
0 0 0 0 0 0 0 0 0 0 0
0 0 0 0 0 0 0 0 0 0 0
0 0 0 0 0 0 0 0 0 0 0
0 0 0 0 0 0 0 0 0 0 0
0 0 0 0 0 0 0 0 0 0 0
0 0 0 0 0 0 0 0 0 0 0
0 0 0 0 0 0 0 0 0 0 0
0 0 0 0 0 0 0 0 0 0 0
0 0 0 0 0 0 0 0 0 0 0
0 0 0 0 0 0 0 0 0 0 0
0 0 0 0 0 0 0 0 0 0 0
0 0 0 0 0 0 0 0 0 0 0