MODE 2
SIZE 11/70
LIMIT 0/1000
COLOR LIMIT 4
STARS 1000/2000/4100
POWERUPS 1/0/0/0
7 11 7 7 7 14 7 7 7 12 7
7 7 30 7 32 32 7 7 7 7 7
7 32 0 7 0 0 0 7 7 0 30
7 32 0 7 7 7 7 0 32 32 7
7 0 0 0 7 7 7 0 0 7 7
1 7 7 0 35 35 0 0 7 7 7
0 30 7 0 15 7 30 0 0 0 7
7 7 7 7 0 35 7 7 7 7 7
0 30 7 7 0 0 0 7 0 7 7
7 7 7 7 7 12 7 7 7 7 7
0 7 7 7 7 0 7 7 7 0 7
18 32 7 7 35 7 7 0 7 7 7
0 7 32 7 0 35 7 7 7 30 7
7 7 7 7 19 0 35 7 7 7 7
0 7 7 7 7 7 7 7 32 32 7
0 7 30 7 7 26 7 7 7 0 7
0 7 0 7 0 0 7 7 0 7 30
7 7 35 7 7 30 7 35 7 7 7
0 7 7 7 22 7 7 7 7 7 7
0 7 7 7 7 7 7 7 7 7 7
0 0 0 0 0 0 0 0 0 0 0
0 0 0 0 0 0 0 0 0 0 0
0 0 0 0 0 0 0 0 0 0 0
0 0 0 0 0 0 0 0 0 0 0
0 0 0 0 0 0 0 0 0 0 0
0 0 0 0 0 0 0 0 0 0 0
0 0 0 0 0 0 0 0 0 0 0
0 0 0 0 0 0 0 0 0 0 0
0 0 0 0 0 0 0 0 0 0 0
0 0 0 0 0 0 0 0 0 0 0
0 0 0 0 0 0 0 0 0 0 0
0 0 0 0 0 0 0 0 0 0 0
0 0 0 0 0 0 0 0 0 0 0
0 0 0 0 0 0 0 0 0 0 0
0 0 0 0 0 0 0 0 0 0 0
0 0 0 0 0 0 0 0 0 0 0
0 0 0 0 0 0 0 0 0 0 0
0 0 0 0 0 0 0 0 0 0 0
0 0 0 0 0 0 0 0 0 0 0
0 0 0 0 0 0 0 0 0 0 0
0 0 0 0 0 0 0 0 0 0 0
0 0 0 0 0 0 0 0 0 0 0
0 0 0 0 0 0 0 0 0 0 0
0 0 0 0 0 0 0 0 0 0 0
0 0 0 0 0 0 0 0 0 0 0
0 0 0 0 0 0 0 0 0 0 0
0 0 0 0 0 0 0 0 0 0 0
0 0 0 0 0 0 0 0 0 0 0
0 0 0 0 0 0 0 0 0 0 0
0 0 0 0 0 0 0 0 0 0 0
0 0 0 0 0 0 0 0 0 0 0
0 0 0 0 0 0 0 0 0 0 0
0 0 0 0 0 0 0 0 0 0 0
0 0 0 0 0 0 0 0 0 0 0
0 0 0 0 0 0 0 0 0 0 0
0 0 0 0 0 0 0 0 0 0 0
0 0 0 0 0 0 0 0 0 0 0
0 0 0 0 0 0 0 0 0 0 0
0 0 0 0 0 0 0 0 0 0 0
0 0 0 0 0 0 0 0 0 0 0
0 0 0 0 0 0 0 0 0 0 0
0 0 0 0 0 0 0 0 0 0 0
0 0 0 0 0 0 0 0 0 0 0
0 0 0 0 0 0 0 0 0 0 0
0 0 0 0 0 0 0 0 0 0 0
0 0 0 0 0 0 0 0 0 0 0
0 0 0 0 0 0 0 0 0 0 0
0 0 0 0 0 0 0 0 0 0 0
0 0 0 0 0 0 0 0 0 0 0
0 0 0 0 0 0 0 0 0 0 0