MODE 2
SIZE 11/70
LIMIT 0/1000
COLOR LIMIT 4
STARS 800/3600/6500
POWERUPS 1/0/0/0
0 7 7 0 0 7 11 0 0 7 7
7 7 32 7 7 7 7 7 7 7 7
7 7 7 15 7 7 7 7 23 7 7
7 7 7 7 7 30 11 7 7 7 7
13 7 7 7 7 7 32 11 30 0 0
7 7 0 35 0 7 7 7 0 0 0
7 7 7 7 15 7 7 7 7 7 7
7 7 7 7 7 7 7 12 0 7 7
7 7 7 0 35 7 7 0 0 7 7
7 7 7 7 22 0 30 30 19 7 0
0 0 7 7 0 35 11 7 7 7 0
0 23 7 7 7 15 32 7 7 7 0
7 7 7 7 7 7 7 7 7 0 7
7 7 7 7 7 7 0 0 7 7 7
7 7 7 11 7 7 35 0 7 7 0
7 7 7 7 7 7 7 7 7 7 0
7 7 7 23 30 11 32 7 7 7 7
7 0 7 7 7 7 7 7 0 7 7
0 7 7 7 0 0 7 0 7 0 7
7 7 0 15 0 7 0 7 7 0 7
0 0 0 0 0 0 0 0 0 0 0
0 0 0 0 0 0 0 0 0 0 0
0 0 0 0 0 0 0 0 0 0 0
0 0 0 0 0 0 0 0 0 0 0
0 0 0 0 0 0 0 0 0 0 0
0 0 0 0 0 0 0 0 0 0 0
0 0 0 0 0 0 0 0 0 0 0
0 0 0 0 0 0 0 0 0 0 0
0 0 0 0 0 0 0 0 0 0 0
0 0 0 0 0 0 0 0 0 0 0
0 0 0 0 0 0 0 0 0 0 0
0 0 0 0 0 0 0 0 0 0 0
0 0 0 0 0 0 0 0 0 0 0
0 0 0 0 0 0 0 0 0 0 0
0 0 0 0 0 0 0 0 0 0 0
0 0 0 0 0 0 0 0 0 0 0
0 0 0 0 0 0 0 0 0 0 0
0 0 0 0 0 0 0 0 0 0 0
0 0 0 0 0 0 0 0 0 0 0
0 0 0 0 0 0 0 0 0 0 0
0 0 0 0 0 0 0 0 0 0 0
0 0 0 0 0 0 0 0 0 0 0
0 0 0 0 0 0 0 0 0 0 0
0 0 0 0 0 0 0 0 0 0 0
0 0 0 0 0 0 0 0 0 0 0
0 0 0 0 0 0 0 0 0 0 0
0 0 0 0 0 0 0 0 0 0 0
0 0 0 0 0 0 0 0 0 0 0
0 0 0 0 0 0 0 0 0 0 0
0 0 0 0 0 0 0 0 0 0 0
0 0 0 0 0 0 0 0 0 0 0
0 0 0 0 0 0 0 0 0 0 0
0 0 0 0 0 0 0 0 0 0 0
0 0 0 0 0 0 0 0 0 0 0
0 0 0 0 0 0 0 0 0 0 0
0 0 0 0 0 0 0 0 0 0 0
0 0 0 0 0 0 0 0 0 0 0
0 0 0 0 0 0 0 0 0 0 0
0 0 0 0 0 0 0 0 0 0 0
0 0 0 0 0 0 0 0 0 0 0
0 0 0 0 0 0 0 0 0 0 0
0 0 0 0 0 0 0 0 0 0 0
0 0 0 0 0 0 0 0 0 0 0
0 0 0 0 0 0 0 0 0 0 0
0 0 0 0 0 0 0 0 0 0 0
0 0 0 0 0 0 0 0 0 0 0
0 0 0 0 0 0 0 0 0 0 0
0 0 0 0 0 0 0 0 0 0 0
0 0 0 0 0 0 0 0 0 0 0
0 0 0 0 0 0 0 0 0 0 0