MODE 2
SIZE 11/70
LIMIT 0/1000
COLOR LIMIT 6
STARS 1000/2500/4800
POWERUPS 1/0/0/0
0 0 0 7 12 15 7 7 7 0 0
0 13 7 7 7 7 7 7 11 7 0
0 0 7 7 25 23 25 7 7 7 0
0 7 14 5 0 35 7 7 23 0 0
0 0 14 29 29 12 7 29 29 23 0
0 26 0 29 7 7 0 29 0 23 0
0 26 13 18 7 35 7 7 7 7 14
26 31 7 7 7 13 7 7 7 7 14
0 31 31 17 7 7 32 11 17 7 7
0 7 7 7 7 7 7 7 7 0 0
0 7 7 7 35 7 35 7 7 7 0
7 7 7 30 7 7 30 7 7 7 0
7 0 7 7 30 29 30 7 7 0 26
7 0 7 7 30 30 7 7 0 0 7
7 0 7 7 7 35 7 7 7 0 7
7 7 0 0 7 7 0 0 0 7 7
15 7 7 18 7 7 7 7 7 7 15
0 7 0 7 7 7 7 7 7 0 0
0 0 7 0 7 7 0 7 0 7 0
0 7 7 7 7 7 7 7 7 7 0
0 0 0 0 0 0 0 0 0 0 0
0 0 0 0 0 0 0 0 0 0 0
0 0 0 0 0 0 0 0 0 0 0
0 0 0 0 0 0 0 0 0 0 0
0 0 0 0 0 0 0 0 0 0 0
0 0 0 0 0 0 0 0 0 0 0
0 0 0 0 0 0 0 0 0 0 0
0 0 0 0 0 0 0 0 0 0 0
0 0 0 0 0 0 0 0 0 0 0
0 0 0 0 0 0 0 0 0 0 0
0 0 0 0 0 0 0 0 0 0 0
0 0 0 0 0 0 0 0 0 0 0
0 0 0 0 0 0 0 0 0 0 0
0 0 0 0 0 0 0 0 0 0 0
0 0 0 0 0 0 0 0 0 0 0
0 0 0 0 0 0 0 0 0 0 0
0 0 0 0 0 0 0 0 0 0 0
0 0 0 0 0 0 0 0 0 0 0
0 0 0 0 0 0 0 0 0 0 0
0 0 0 0 0 0 0 0 0 0 0
0 0 0 0 0 0 0 0 0 0 0
0 0 0 0 0 0 0 0 0 0 0
0 0 0 0 0 0 0 0 0 0 0
0 0 0 0 0 0 0 0 0 0 0
0 0 0 0 0 0 0 0 0 0 0
0 0 0 0 0 0 0 0 0 0 0
0 0 0 0 0 0 0 0 0 0 0
0 0 0 0 0 0 0 0 0 0 0
0 0 0 0 0 0 0 0 0 0 0
0 0 0 0 0 0 0 0 0 0 0
0 0 0 0 0 0 0 0 0 0 0
0 0 0 0 0 0 0 0 0 0 0
0 0 0 0 0 0 0 0 0 0 0
0 0 0 0 0 0 0 0 0 0 0
0 0 0 0 0 0 0 0 0 0 0
0 0 0 0 0 0 0 0 0 0 0
0 0 0 0 0 0 0 0 0 0 0
0 0 0 0 0 0 0 0 0 0 0
0 0 0 0 0 0 0 0 0 0 0
0 0 0 0 0 0 0 0 0 0 0
0 0 0 0 0 0 0 0 0 0 0
0 0 0 0 0 0 0 0 0 0 0
0 0 0 0 0 0 0 0 0 0 0
0 0 0 0 0 0 0 0 0 0 0
0 0 0 0 0 0 0 0 0 0 0
0 0 0 0 0 0 0 0 0 0 0
0 0 0 0 0 0 0 0 0 0 0
0 0 0 0 0 0 0 0 0 0 0
0 0 0 0 0 0 0 0 0 0 0
0 0 0 0 0 0 0 0 0 0 0