MODE 2
SIZE 11/70
LIMIT 0/1000
COLOR LIMIT 4
STARS 300/900/1700
POWERUPS 1/0/0/0
7 27 7 11 7 15 7 7 7 27 17
7 7 7 0 7 7 0 0 7 7 7
7 17 35 31 7 17 35 31 7 17 7
7 7 0 0 7 7 0 0 7 7 0
7 17 7 31 7 17 7 11 7 17 7
7 32 0 0 7 35 7 0 32 7 0
7 17 7 30 7 17 7 30 7 17 7
7 7 0 7 7 7 7 0 7 7 0
7 17 7 7 32 17 24 32 7 17 7
7 7 7 35 7 7 11 35 7 7 7
0 0 7 7 7 0 7 7 7 0 0
0 0 7 30 0 0 30 7 0 0 0
0 0 7 24 7 7 28 7 7 0 0
0 7 7 7 35 7 7 7 7 0 0
0 0 7 7 0 0 7 7 0 0 0
0 7 7 7 7 7 7 7 0 0 0
0 0 7 7 0 0 7 7 0 0 0
0 7 0 7 7 7 0 7 0 0 0
0 0 7 7 7 7 7 0 7 0 0
0 0 7 7 30 30 7 7 0 0 0
0 0 0 0 0 0 0 0 0 0 0
0 0 0 0 0 0 0 0 0 0 0
0 0 0 0 0 0 0 0 0 0 0
0 0 0 0 0 0 0 0 0 0 0
0 0 0 0 0 0 0 0 0 0 0
0 0 0 0 0 0 0 0 0 0 0
0 0 0 0 0 0 0 0 0 0 0
0 0 0 0 0 0 0 0 0 0 0
0 0 0 0 0 0 0 0 0 0 0
0 0 0 0 0 0 0 0 0 0 0
0 0 0 0 0 0 0 0 0 0 0
0 0 0 0 0 0 0 0 0 0 0
0 0 0 0 0 0 0 0 0 0 0
0 0 0 0 0 0 0 0 0 0 0
0 0 0 0 0 0 0 0 0 0 0
0 0 0 0 0 0 0 0 0 0 0
0 0 0 0 0 0 0 0 0 0 0
0 0 0 0 0 0 0 0 0 0 0
0 0 0 0 0 0 0 0 0 0 0
0 0 0 0 0 0 0 0 0 0 0
0 0 0 0 0 0 0 0 0 0 0
0 0 0 0 0 0 0 0 0 0 0
0 0 0 0 0 0 0 0 0 0 0
0 0 0 0 0 0 0 0 0 0 0
0 0 0 0 0 0 0 0 0 0 0
0 0 0 0 0 0 0 0 0 0 0
0 0 0 0 0 0 0 0 0 0 0
0 0 0 0 0 0 0 0 0 0 0
0 0 0 0 0 0 0 0 0 0 0
0 0 0 0 0 0 0 0 0 0 0
0 0 0 0 0 0 0 0 0 0 0
0 0 0 0 0 0 0 0 0 0 0
0 0 0 0 0 0 0 0 0 0 0
0 0 0 0 0 0 0 0 0 0 0
0 0 0 0 0 0 0 0 0 0 0
0 0 0 0 0 0 0 0 0 0 0
0 0 0 0 0 0 0 0 0 0 0
0 0 0 0 0 0 0 0 0 0 0
0 0 0 0 0 0 0 0 0 0 0
0 0 0 0 0 0 0 0 0 0 0
0 0 0 0 0 0 0 0 0 0 0
0 0 0 0 0 0 0 0 0 0 0
0 0 0 0 0 0 0 0 0 0 0
0 0 0 0 0 0 0 0 0 0 0
0 0 0 0 0 0 0 0 0 0 0
0 0 0 0 0 0 0 0 0 0 0
0 0 0 0 0 0 0 0 0 0 0
0 0 0 0 0 0 0 0 0 0 0
0 0 0 0 0 0 0 0 0 0 0
0 0 0 0 0 0 0 0 0 0 0