MODE 2
SIZE 11/70
LIMIT 0/1000
COLOR LIMIT 4
STARS 1200/4200/6700
POWERUPS 1/0/0/0
7 7 7 0 0 7 7 7 7 13 0
7 7 7 0 0 7 0 0 7 7 7
7 12 12 7 7 7 7 26 26 26 7
7 7 32 32 35 7 35 32 32 7 7
7 7 23 23 7 35 7 7 7 7 7
7 7 7 7 32 32 7 7 7 7 7
7 7 30 30 7 35 32 17 17 17 7
7 12 7 7 7 7 7 30 7 7 7
7 17 17 17 7 7 7 7 0 0 7
7 0 0 0 7 35 7 7 0 0 7
7 7 7 7 7 30 7 17 17 17 7
0 0 0 0 0 30 7 7 7 7 7
0 7 7 7 7 7 7 0 0 0 0
0 30 30 7 7 35 7 7 7 0 0
7 7 7 26 26 26 26 26 7 7 7
15 0 0 7 7 0 7 30 7 7 0
0 15 0 7 0 7 7 30 7 7 0
0 7 0 7 7 0 7 7 7 0 0
0 0 7 7 7 0 7 7 18 0 0
0 0 7 7 7 7 7 18 0 0 0
0 0 0 0 0 0 0 0 0 0 0
0 0 0 0 0 0 0 0 0 0 0
0 0 0 0 0 0 0 0 0 0 0
0 0 0 0 0 0 0 0 0 0 0
0 0 0 0 0 0 0 0 0 0 0
0 0 0 0 0 0 0 0 0 0 0
0 0 0 0 0 0 0 0 0 0 0
0 0 0 0 0 0 0 0 0 0 0
0 0 0 0 0 0 0 0 0 0 0
0 0 0 0 0 0 0 0 0 0 0
0 0 0 0 0 0 0 0 0 0 0
0 0 0 0 0 0 0 0 0 0 0
0 0 0 0 0 0 0 0 0 0 0
0 0 0 0 0 0 0 0 0 0 0
0 0 0 0 0 0 0 0 0 0 0
0 0 0 0 0 0 0 0 0 0 0
0 0 0 0 0 0 0 0 0 0 0
0 0 0 0 0 0 0 0 0 0 0
0 0 0 0 0 0 0 0 0 0 0
0 0 0 0 0 0 0 0 0 0 0
0 0 0 0 0 0 0 0 0 0 0
0 0 0 0 0 0 0 0 0 0 0
0 0 0 0 0 0 0 0 0 0 0
0 0 0 0 0 0 0 0 0 0 0
0 0 0 0 0 0 0 0 0 0 0
0 0 0 0 0 0 0 0 0 0 0
0 0 0 0 0 0 0 0 0 0 0
0 0 0 0 0 0 0 0 0 0 0
0 0 0 0 0 0 0 0 0 0 0
0 0 0 0 0 0 0 0 0 0 0
0 0 0 0 0 0 0 0 0 0 0
0 0 0 0 0 0 0 0 0 0 0
0 0 0 0 0 0 0 0 0 0 0
0 0 0 0 0 0 0 0 0 0 0
0 0 0 0 0 0 0 0 0 0 0
0 0 0 0 0 0 0 0 0 0 0
0 0 0 0 0 0 0 0 0 0 0
0 0 0 0 0 0 0 0 0 0 0
0 0 0 0 0 0 0 0 0 0 0
0 0 0 0 0 0 0 0 0 0 0
0 0 0 0 0 0 0 0 0 0 0
0 0 0 0 0 0 0 0 0 0 0
0 0 0 0 0 0 0 0 0 0 0
0 0 0 0 0 0 0 0 0 0 0
0 0 0 0 0 0 0 0 0 0 0
0 0 0 0 0 0 0 0 0 0 0
0 0 0 0 0 0 0 0 0 0 0
0 0 0 0 0 0 0 0 0 0 0
0 0 0 0 0 0 0 0 0 0 0
0 0 0 0 0 0 0 0 0 0 0