MODE 2
SIZE 11/70
LIMIT 0/1000
COLOR LIMIT 4
STARS 1200/3100/5000
POWERUPS 1/0/0/0
7 13 7 11 7 7 7 7 12 7 7
7 7 32 7 30 7 7 32 7 7 7
7 7 7 32 30 30 32 35 32 7 7
7 7 7 35 7 7 32 7 32 7 7
26 26 26 26 26 26 21 21 21 21 21
7 29 7 30 30 30 7 35 7 7 7
7 7 29 7 30 30 7 35 7 35 30
7 7 29 7 7 7 29 7 7 7 7
7 7 7 29 7 7 29 7 7 7 7
12 12 12 12 12 17 17 17 17 17 17
7 7 7 7 7 35 7 7 7 7 7
0 7 7 7 7 7 7 7 7 0 0
0 7 7 7 7 30 7 7 7 7 0
0 7 7 0 7 30 0 0 7 7 0
0 7 7 0 30 30 7 0 7 7 0
0 7 0 7 30 30 7 0 7 0 0
0 7 7 0 7 30 7 0 7 7 0
0 7 0 0 7 7 0 0 7 0 0
0 7 7 0 0 7 0 0 7 7 0
0 7 7 0 0 0 0 0 7 7 0
0 0 0 0 0 0 0 0 0 0 0
0 0 0 0 0 0 0 0 0 0 0
0 0 0 0 0 0 0 0 0 0 0
0 0 0 0 0 0 0 0 0 0 0
0 0 0 0 0 0 0 0 0 0 0
0 0 0 0 0 0 0 0 0 0 0
0 0 0 0 0 0 0 0 0 0 0
0 0 0 0 0 0 0 0 0 0 0
0 0 0 0 0 0 0 0 0 0 0
0 0 0 0 0 0 0 0 0 0 0
0 0 0 0 0 0 0 0 0 0 0
0 0 0 0 0 0 0 0 0 0 0
0 0 0 0 0 0 0 0 0 0 0
0 0 0 0 0 0 0 0 0 0 0
0 0 0 0 0 0 0 0 0 0 0
0 0 0 0 0 0 0 0 0 0 0
0 0 0 0 0 0 0 0 0 0 0
0 0 0 0 0 0 0 0 0 0 0
0 0 0 0 0 0 0 0 0 0 0
0 0 0 0 0 0 0 0 0 0 0
0 0 0 0 0 0 0 0 0 0 0
0 0 0 0 0 0 0 0 0 0 0
0 0 0 0 0 0 0 0 0 0 0
0 0 0 0 0 0 0 0 0 0 0
0 0 0 0 0 0 0 0 0 0 0
0 0 0 0 0 0 0 0 0 0 0
0 0 0 0 0 0 0 0 0 0 0
0 0 0 0 0 0 0 0 0 0 0
0 0 0 0 0 0 0 0 0 0 0
0 0 0 0 0 0 0 0 0 0 0
0 0 0 0 0 0 0 0 0 0 0
0 0 0 0 0 0 0 0 0 0 0
0 0 0 0 0 0 0 0 0 0 0
0 0 0 0 0 0 0 0 0 0 0
0 0 0 0 0 0 0 0 0 0 0
0 0 0 0 0 0 0 0 0 0 0
0 0 0 0 0 0 0 0 0 0 0
0 0 0 0 0 0 0 0 0 0 0
0 0 0 0 0 0 0 0 0 0 0
0 0 0 0 0 0 0 0 0 0 0
0 0 0 0 0 0 0 0 0 0 0
0 0 0 0 0 0 0 0 0 0 0
0 0 0 0 0 0 0 0 0 0 0
0 0 0 0 0 0 0 0 0 0 0
0 0 0 0 0 0 0 0 0 0 0
0 0 0 0 0 0 0 0 0 0 0
0 0 0 0 0 0 0 0 0 0 0
0 0 0 0 0 0 0 0 0 0 0
0 0 0 0 0 0 0 0 0 0 0
0 0 0 0 0 0 0 0 0 0 0