MODE 2
SIZE 11/70
LIMIT 0/1000
COLOR LIMIT 4
STARS 1200/4900/7100
POWERUPS 1/0/0/0
11 7 16 12 7 7 13 7 7 12 7
35 7 7 19 7 7 27 7 7 19 7
7 7 7 7 7 7 35 7 7 35 7
7 7 7 35 7 7 16 7 7 7 7
18 0 18 31 18 31 18 31 18 0 18
7 17 32 14 31 30 23 31 14 29 23
7 17 32 27 31 30 23 31 14 29 23
7 32 7 31 30 7 31 7 20 7 7
7 32 7 31 30 7 31 7 20 7 7
18 7 18 0 18 0 18 0 18 0 18
13 7 7 16 35 7 16 7 7 7 13
7 20 32 7 20 32 7 20 32 13 7
32 7 7 16 7 32 21 7 16 7 21
7 21 7 7 7 35 7 7 7 7 7
0 17 31 7 31 27 31 7 31 17 0
7 7 7 7 20 20 7 7 7 0 0
0 31 7 7 7 31 7 7 7 31 0
7 7 7 7 7 31 7 7 0 7 0
0 7 7 7 7 7 31 7 31 7 7
7 30 30 0 0 0 0 0 30 30 7
0 0 0 0 0 0 0 0 0 0 0
0 0 0 0 0 0 0 0 0 0 0
0 0 0 0 0 0 0 0 0 0 0
0 0 0 0 0 0 0 0 0 0 0
0 0 0 0 0 0 0 0 0 0 0
0 0 0 0 0 0 0 0 0 0 0
0 0 0 0 0 0 0 0 0 0 0
0 0 0 0 0 0 0 0 0 0 0
0 0 0 0 0 0 0 0 0 0 0
0 0 0 0 0 0 0 0 0 0 0
0 0 0 0 0 0 0 0 0 0 0
0 0 0 0 0 0 0 0 0 0 0
0 0 0 0 0 0 0 0 0 0 0
0 0 0 0 0 0 0 0 0 0 0
0 0 0 0 0 0 0 0 0 0 0
0 0 0 0 0 0 0 0 0 0 0
0 0 0 0 0 0 0 0 0 0 0
0 0 0 0 0 0 0 0 0 0 0
0 0 0 0 0 0 0 0 0 0 0
0 0 0 0 0 0 0 0 0 0 0
0 0 0 0 0 0 0 0 0 0 0
0 0 0 0 0 0 0 0 0 0 0
0 0 0 0 0 0 0 0 0 0 0
0 0 0 0 0 0 0 0 0 0 0
0 0 0 0 0 0 0 0 0 0 0
0 0 0 0 0 0 0 0 0 0 0
0 0 0 0 0 0 0 0 0 0 0
0 0 0 0 0 0 0 0 0 0 0
0 0 0 0 0 0 0 0 0 0 0
0 0 0 0 0 0 0 0 0 0 0
0 0 0 0 0 0 0 0 0 0 0
0 0 0 0 0 0 0 0 0 0 0
0 0 0 0 0 0 0 0 0 0 0
0 0 0 0 0 0 0 0 0 0 0
0 0 0 0 0 0 0 0 0 0 0
0 0 0 0 0 0 0 0 0 0 0
0 0 0 0 0 0 0 0 0 0 0
0 0 0 0 0 0 0 0 0 0 0
0 0 0 0 0 0 0 0 0 0 0
0 0 0 0 0 0 0 0 0 0 0
0 0 0 0 0 0 0 0 0 0 0
0 0 0 0 0 0 0 0 0 0 0
0 0 0 0 0 0 0 0 0 0 0
0 0 0 0 0 0 0 0 0 0 0
0 0 0 0 0 0 0 0 0 0 0
0 0 0 0 0 0 0 0 0 0 0
0 0 0 0 0 0 0 0 0 0 0
0 0 0 0 0 0 0 0 0 0 0
0 0 0 0 0 0 0 0 0 0 0
0 0 0 0 0 0 0 0 0 0 0