MODE 2
SIZE 11/70
LIMIT 0/1000
COLOR LIMIT 4
STARS 500/1400/2600
POWERUPS 1/0/0/0
7 7 7 7 7 7 7 7 7 7 7
7 11 7 7 17 7 35 20 7 7 7
7 7 7 7 7 30 7 7 7 7 7
7 14 7 35 30 30 7 7 23 7 7
7 7 7 7 30 7 30 7 7 7 7
7 29 29 30 7 7 30 7 31 29 7
7 31 35 31 7 23 7 7 31 35 29
7 31 31 7 23 23 7 7 31 31 7
7 7 7 7 7 7 7 7 7 7 7
0 0 7 11 11 0 0 7 0 0 0
0 0 7 7 26 26 26 7 7 0 0
7 30 11 11 35 11 1 30 30 7 7
0 30 7 7 23 23 23 7 7 30 0
30 30 0 0 0 0 0 0 30 30 0
29 31 31 31 31 29 29 31 31 31 29
7 0 7 35 7 7 7 7 7 0 7
0 7 0 7 7 7 7 7 7 0 7
0 7 30 7 30 26 30 7 30 7 0
7 7 30 7 30 26 26 30 7 30 7
7 30 7 30 7 0 7 7 7 30 7
0 0 7 0 0 7 0 0 7 0 0
0 0 0 0 0 0 0 0 0 0 0
0 0 0 0 0 0 0 0 0 0 0
0 0 0 0 0 0 0 0 0 0 0
0 0 0 0 0 0 0 0 0 0 0
0 0 0 0 0 0 0 0 0 0 0
0 0 0 0 0 0 0 0 0 0 0
0 0 0 0 0 0 0 0 0 0 0
0 0 0 0 0 0 0 0 0 0 0
0 0 0 0 0 0 0 0 0 0 0
0 0 0 0 0 0 0 0 0 0 0
0 0 0 0 0 0 0 0 0 0 0
0 0 0 0 0 0 0 0 0 0 0
0 0 0 0 0 0 0 0 0 0 0
0 0 0 0 0 0 0 0 0 0 0
0 0 0 0 0 0 0 0 0 0 0
0 0 0 0 0 0 0 0 0 0 0
0 0 0 0 0 0 0 0 0 0 0
0 0 0 0 0 0 0 0 0 0 0
0 0 0 0 0 0 0 0 0 0 0
0 0 0 0 0 0 0 0 0 0 0
0 0 0 0 0 0 0 0 0 0 0
0 0 0 0 0 0 0 0 0 0 0
0 0 0 0 0 0 0 0 0 0 0
0 0 0 0 0 0 0 0 0 0 0
0 0 0 0 0 0 0 0 0 0 0
0 0 0 0 0 0 0 0 0 0 0
0 0 0 0 0 0 0 0 0 0 0
0 0 0 0 0 0 0 0 0 0 0
0 0 0 0 0 0 0 0 0 0 0
0 0 0 0 0 0 0 0 0 0 0
0 0 0 0 0 0 0 0 0 0 0
0 0 0 0 0 0 0 0 0 0 0
0 0 0 0 0 0 0 0 0 0 0
0 0 0 0 0 0 0 0 0 0 0
0 0 0 0 0 0 0 0 0 0 0
0 0 0 0 0 0 0 0 0 0 0
0 0 0 0 0 0 0 0 0 0 0
0 0 0 0 0 0 0 0 0 0 0
0 0 0 0 0 0 0 0 0 0 0
0 0 0 0 0 0 0 0 0 0 0
0 0 0 0 0 0 0 0 0 0 0
0 0 0 0 0 0 0 0 0 0 0
0 0 0 0 0 0 0 0 0 0 0
0 0 0 0 0 0 0 0 0 0 0
0 0 0 0 0 0 0 0 0 0 0
0 0 0 0 0 0 0 0 0 0 0
0 0 0 0 0 0 0 0 0 0 0
0 0 0 0 0 0 0 0 0 0 0
0 0 0 0 0 0 0 0 0 0 0