MODE 2
SIZE 11/70
LIMIT 0/1000
COLOR LIMIT 5
STARS 1000/3900/5500
POWERUPS 1/0/0/0
7 7 7 30 7 7 30 7 7 7 7
7 14 7 7 26 7 7 11 7 7 13
7 7 7 30 7 35 30 7 7 30 7
7 30 7 7 30 7 7 30 7 7 7
12 7 7 11 7 7 17 7 7 14 7
7 30 35 7 30 7 35 30 7 7 7
7 7 7 32 7 7 32 7 7 32 7
7 23 7 7 17 7 7 17 7 7 7
7 7 7 32 11 7 32 7 7 32 7
7 0 7 7 35 7 7 0 7 7 7
32 7 7 17 7 7 23 7 7 17 7
32 0 7 7 35 7 7 0 7 7 32
7 7 7 31 7 7 0 7 7 11 32
7 17 7 7 17 7 7 17 7 32 32
0 7 7 11 7 7 17 7 7 31 7
0 7 31 31 0 17 35 31 31 0 0
0 30 35 7 17 17 17 7 7 30 0
30 30 7 7 7 30 7 7 30 30 0
0 17 7 7 7 30 30 7 7 7 0
0 17 7 11 0 30 0 11 11 0 0
0 0 0 0 0 0 0 0 0 0 0
0 0 0 0 0 0 0 0 0 0 0
0 0 0 0 0 0 0 0 0 0 0
0 0 0 0 0 0 0 0 0 0 0
0 0 0 0 0 0 0 0 0 0 0
0 0 0 0 0 0 0 0 0 0 0
0 0 0 0 0 0 0 0 0 0 0
0 0 0 0 0 0 0 0 0 0 0
0 0 0 0 0 0 0 0 0 0 0
0 0 0 0 0 0 0 0 0 0 0
0 0 0 0 0 0 0 0 0 0 0
0 0 0 0 0 0 0 0 0 0 0
0 0 0 0 0 0 0 0 0 0 0
0 0 0 0 0 0 0 0 0 0 0
0 0 0 0 0 0 0 0 0 0 0
0 0 0 0 0 0 0 0 0 0 0
0 0 0 0 0 0 0 0 0 0 0
0 0 0 0 0 0 0 0 0 0 0
0 0 0 0 0 0 0 0 0 0 0
0 0 0 0 0 0 0 0 0 0 0
0 0 0 0 0 0 0 0 0 0 0
0 0 0 0 0 0 0 0 0 0 0
0 0 0 0 0 0 0 0 0 0 0
0 0 0 0 0 0 0 0 0 0 0
0 0 0 0 0 0 0 0 0 0 0
0 0 0 0 0 0 0 0 0 0 0
0 0 0 0 0 0 0 0 0 0 0
0 0 0 0 0 0 0 0 0 0 0
0 0 0 0 0 0 0 0 0 0 0
0 0 0 0 0 0 0 0 0 0 0
0 0 0 0 0 0 0 0 0 0 0
0 0 0 0 0 0 0 0 0 0 0
0 0 0 0 0 0 0 0 0 0 0
0 0 0 0 0 0 0 0 0 0 0
0 0 0 0 0 0 0 0 0 0 0
0 0 0 0 0 0 0 0 0 0 0
0 0 0 0 0 0 0 0 0 0 0
0 0 0 0 0 0 0 0 0 0 0
0 0 0 0 0 0 0 0 0 0 0
0 0 0 0 0 0 0 0 0 0 0
0 0 0 0 0 0 0 0 0 0 0
0 0 0 0 0 0 0 0 0 0 0
0 0 0 0 0 0 0 0 0 0 0
0 0 0 0 0 0 0 0 0 0 0
0 0 0 0 0 0 0 0 0 0 0
0 0 0 0 0 0 0 0 0 0 0
0 0 0 0 0 0 0 0 0 0 0
0 0 0 0 0 0 0 0 0 0 0
0 0 0 0 0 0 0 0 0 0 0
0 0 0 0 0 0 0 0 0 0 0