MODE 2
SIZE 11/70
LIMIT 0/1000
COLOR LIMIT 5
STARS 1000/2100/5000
POWERUPS 1/0/0/0
7 7 7 7 7 7 7 14 7 7 7
30 7 30 7 30 7 30 7 30 7 30
7 31 7 31 7 7 31 35 31 7 31
7 35 0 7 7 7 7 7 0 35 7
7 7 0 0 7 31 7 7 14 0 7
7 7 35 7 7 11 7 7 14 7 7
31 29 31 7 31 18 31 18 31 29 31
21 0 7 7 7 7 7 7 7 0 7
21 7 0 14 14 7 7 28 0 7 7
7 7 7 14 7 7 28 7 7 14 7
7 14 7 7 23 14 21 7 7 7 7
7 0 7 7 7 35 21 7 0 7 7
7 7 14 7 23 7 7 14 7 7 7
0 31 0 29 0 31 0 31 0 0 0
0 0 7 7 31 7 0 7 7 7 0
0 7 14 14 7 7 7 0 7 7 0
0 7 7 0 7 7 7 7 0 7 0
7 0 0 0 7 7 0 7 7 0 0
7 32 7 11 7 32 7 0 7 7 7
7 32 7 7 32 7 7 7 0 7 7
7 7 0 7 0 7 7 7 23 0 7
0 0 0 0 0 0 0 0 0 0 0
0 0 0 0 0 0 0 0 0 0 0
0 0 0 0 0 0 0 0 0 0 0
0 0 0 0 0 0 0 0 0 0 0
0 0 0 0 0 0 0 0 0 0 0
0 0 0 0 0 0 0 0 0 0 0
0 0 0 0 0 0 0 0 0 0 0
0 0 0 0 0 0 0 0 0 0 0
0 0 0 0 0 0 0 0 0 0 0
0 0 0 0 0 0 0 0 0 0 0
0 0 0 0 0 0 0 0 0 0 0
0 0 0 0 0 0 0 0 0 0 0
0 0 0 0 0 0 0 0 0 0 0
0 0 0 0 0 0 0 0 0 0 0
0 0 0 0 0 0 0 0 0 0 0
0 0 0 0 0 0 0 0 0 0 0
0 0 0 0 0 0 0 0 0 0 0
0 0 0 0 0 0 0 0 0 0 0
0 0 0 0 0 0 0 0 0 0 0
0 0 0 0 0 0 0 0 0 0 0
0 0 0 0 0 0 0 0 0 0 0
0 0 0 0 0 0 0 0 0 0 0
0 0 0 0 0 0 0 0 0 0 0
0 0 0 0 0 0 0 0 0 0 0
0 0 0 0 0 0 0 0 0 0 0
0 0 0 0 0 0 0 0 0 0 0
0 0 0 0 0 0 0 0 0 0 0
0 0 0 0 0 0 0 0 0 0 0
0 0 0 0 0 0 0 0 0 0 0
0 0 0 0 0 0 0 0 0 0 0
0 0 0 0 0 0 0 0 0 0 0
0 0 0 0 0 0 0 0 0 0 0
0 0 0 0 0 0 0 0 0 0 0
0 0 0 0 0 0 0 0 0 0 0
0 0 0 0 0 0 0 0 0 0 0
0 0 0 0 0 0 0 0 0 0 0
0 0 0 0 0 0 0 0 0 0 0
0 0 0 0 0 0 0 0 0 0 0
0 0 0 0 0 0 0 0 0 0 0
0 0 0 0 0 0 0 0 0 0 0
0 0 0 0 0 0 0 0 0 0 0
0 0 0 0 0 0 0 0 0 0 0
0 0 0 0 0 0 0 0 0 0 0
0 0 0 0 0 0 0 0 0 0 0
0 0 0 0 0 0 0 0 0 0 0
0 0 0 0 0 0 0 0 0 0 0
0 0 0 0 0 0 0 0 0 0 0
0 0 0 0 0 0 0 0 0 0 0
0 0 0 0 0 0 0 0 0 0 0