MODE 2
SIZE 11/70
LIMIT 0/1000
COLOR LIMIT 5
STARS 900/2600/4800
POWERUPS 1/0/0/0
7 30 7 30 7 30 7 30 7 30 7
11 12 17 17 7 7 17 17 12 15 0
0 30 0 0 0 7 0 0 0 30 0
30 30 0 0 7 7 0 0 30 30 0
7 7 7 7 7 35 7 7 7 7 7
29 0 29 7 7 7 7 7 29 0 29
0 29 29 7 0 26 26 0 7 29 29
0 29 0 7 7 35 7 7 0 29 0
0 31 31 0 7 7 7 7 31 31 0
0 31 0 0 7 7 7 0 31 0 0
7 14 7 17 7 11 7 26 7 23 7
0 0 7 7 35 0 0 7 7 7 0
0 0 7 7 0 35 0 7 7 7 0
0 7 7 0 0 7 7 7 0 0 0
7 7 35 7 7 7 7 7 7 7 7
32 32 32 32 32 32 32 32 32 32 32
7 0 7 7 0 7 7 0 7 0 7
7 7 0 26 26 0 7 7 7 0 7
0 7 11 11 7 11 11 7 0 7 7
7 7 0 0 7 7 0 7 7 0 0
0 0 0 0 0 0 0 0 0 0 0
0 0 0 0 0 0 0 0 0 0 0
0 0 0 0 0 0 0 0 0 0 0
0 0 0 0 0 0 0 0 0 0 0
0 0 0 0 0 0 0 0 0 0 0
0 0 0 0 0 0 0 0 0 0 0
0 0 0 0 0 0 0 0 0 0 0
0 0 0 0 0 0 0 0 0 0 0
0 0 0 0 0 0 0 0 0 0 0
0 0 0 0 0 0 0 0 0 0 0
0 0 0 0 0 0 0 0 0 0 0
0 0 0 0 0 0 0 0 0 0 0
0 0 0 0 0 0 0 0 0 0 0
0 0 0 0 0 0 0 0 0 0 0
0 0 0 0 0 0 0 0 0 0 0
0 0 0 0 0 0 0 0 0 0 0
0 0 0 0 0 0 0 0 0 0 0
0 0 0 0 0 0 0 0 0 0 0
0 0 0 0 0 0 0 0 0 0 0
0 0 0 0 0 0 0 0 0 0 0
0 0 0 0 0 0 0 0 0 0 0
0 0 0 0 0 0 0 0 0 0 0
0 0 0 0 0 0 0 0 0 0 0
0 0 0 0 0 0 0 0 0 0 0
0 0 0 0 0 0 0 0 0 0 0
0 0 0 0 0 0 0 0 0 0 0
0 0 0 0 0 0 0 0 0 0 0
0 0 0 0 0 0 0 0 0 0 0
0 0 0 0 0 0 0 0 0 0 0
0 0 0 0 0 0 0 0 0 0 0
0 0 0 0 0 0 0 0 0 0 0
0 0 0 0 0 0 0 0 0 0 0
0 0 0 0 0 0 0 0 0 0 0
0 0 0 0 0 0 0 0 0 0 0
0 0 0 0 0 0 0 0 0 0 0
0 0 0 0 0 0 0 0 0 0 0
0 0 0 0 0 0 0 0 0 0 0
0 0 0 0 0 0 0 0 0 0 0
0 0 0 0 0 0 0 0 0 0 0
0 0 0 0 0 0 0 0 0 0 0
0 0 0 0 0 0 0 0 0 0 0
0 0 0 0 0 0 0 0 0 0 0
0 0 0 0 0 0 0 0 0 0 0
0 0 0 0 0 0 0 0 0 0 0
0 0 0 0 0 0 0 0 0 0 0
0 0 0 0 0 0 0 0 0 0 0
0 0 0 0 0 0 0 0 0 0 0
0 0 0 0 0 0 0 0 0 0 0
0 0 0 0 0 0 0 0 0 0 0
0 0 0 0 0 0 0 0 0 0 0