MODE 2
SIZE 11/70
LIMIT 0/1000
COLOR LIMIT 5
STARS 1000/3000/9000
POWERUPS 1/0/0/0
7 18 18 11 7 12 7 17 14 7 13
18 18 7 7 7 7 7 17 7 7 7
18 18 7 15 15 7 7 7 7 7 7
7 7 15 7 15 7 7 35 15 15 7
7 7 7 35 7 27 7 7 15 7 15
7 17 7 7 27 27 7 7 18 18 18
7 7 17 7 27 7 27 35 7 18 18
7 35 7 7 7 7 7 7 7 18 18
7 7 7 7 7 7 7 7 7 7 7
7 7 29 7 27 27 27 7 29 7 7
18 18 18 29 7 7 7 7 29 17 7
18 18 29 35 7 7 7 29 7 17 7
18 18 29 7 7 15 7 7 29 7 7
7 29 7 7 35 15 7 7 29 7 7
7 7 7 7 15 15 15 7 7 7 7
7 7 7 7 7 7 7 35 7 7 0
0 0 7 7 7 7 7 7 7 28 0
0 28 7 31 7 7 30 7 28 28 0
0 28 28 31 7 7 7 11 11 7 7
0 7 31 28 7 30 11 11 11 7 7
0 0 0 0 0 0 0 0 0 0 0
0 0 0 0 0 0 0 0 0 0 0
0 0 0 0 0 0 0 0 0 0 0
0 0 0 0 0 0 0 0 0 0 0
0 0 0 0 0 0 0 0 0 0 0
0 0 0 0 0 0 0 0 0 0 0
0 0 0 0 0 0 0 0 0 0 0
0 0 0 0 0 0 0 0 0 0 0
0 0 0 0 0 0 0 0 0 0 0
0 0 0 0 0 0 0 0 0 0 0
0 0 0 0 0 0 0 0 0 0 0
0 0 0 0 0 0 0 0 0 0 0
0 0 0 0 0 0 0 0 0 0 0
0 0 0 0 0 0 0 0 0 0 0
0 0 0 0 0 0 0 0 0 0 0
0 0 0 0 0 0 0 0 0 0 0
0 0 0 0 0 0 0 0 0 0 0
0 0 0 0 0 0 0 0 0 0 0
0 0 0 0 0 0 0 0 0 0 0
0 0 0 0 0 0 0 0 0 0 0
0 0 0 0 0 0 0 0 0 0 0
0 0 0 0 0 0 0 0 0 0 0
0 0 0 0 0 0 0 0 0 0 0
0 0 0 0 0 0 0 0 0 0 0
0 0 0 0 0 0 0 0 0 0 0
0 0 0 0 0 0 0 0 0 0 0
0 0 0 0 0 0 0 0 0 0 0
0 0 0 0 0 0 0 0 0 0 0
0 0 0 0 0 0 0 0 0 0 0
0 0 0 0 0 0 0 0 0 0 0
0 0 0 0 0 0 0 0 0 0 0
0 0 0 0 0 0 0 0 0 0 0
0 0 0 0 0 0 0 0 0 0 0
0 0 0 0 0 0 0 0 0 0 0
0 0 0 0 0 0 0 0 0 0 0
0 0 0 0 0 0 0 0 0 0 0
0 0 0 0 0 0 0 0 0 0 0
0 0 0 0 0 0 0 0 0 0 0
0 0 0 0 0 0 0 0 0 0 0
0 0 0 0 0 0 0 0 0 0 0
0 0 0 0 0 0 0 0 0 0 0
0 0 0 0 0 0 0 0 0 0 0
0 0 0 0 0 0 0 0 0 0 0
0 0 0 0 0 0 0 0 0 0 0
0 0 0 0 0 0 0 0 0 0 0
0 0 0 0 0 0 0 0 0 0 0
0 0 0 0 0 0 0 0 0 0 0
0 0 0 0 0 0 0 0 0 0 0
0 0 0 0 0 0 0 0 0 0 0
0 0 0 0 0 0 0 0 0 0 0