MODE 2
SIZE 11/70
LIMIT 0/1000
COLOR LIMIT 5
STARS 500/1800/4200
POWERUPS 1/0/0/0
7 7 7 7 7 7 7 7 18 7 7
7 26 7 7 7 7 30 18 7 7 7
7 26 26 35 7 7 30 30 7 7 7
7 7 7 18 18 30 18 30 7 7 7
7 7 12 30 18 7 7 7 7 7 7
7 7 18 30 18 7 35 26 26 7 0
7 30 30 30 30 18 35 26 26 7 7
18 18 30 18 30 18 18 30 7 7 7
7 7 7 7 35 7 7 18 7 30 7
7 26 7 7 7 7 30 30 7 7 7
7 26 26 7 18 18 30 30 18 18 14
7 7 7 7 18 35 7 7 18 7 7
7 7 7 30 7 30 7 30 30 30 7
7 26 35 7 7 30 7 18 7 7 7
7 26 26 7 7 7 30 18 29 7 7
18 18 30 30 30 30 18 29 13 7 7
7 7 7 18 7 7 29 7 7 7 7
7 35 7 18 7 29 7 7 7 26 7
7 7 7 7 18 18 7 7 7 26 26
0 0 0 0 0 0 0 0 0 0 0
0 0 0 0 0 0 0 0 0 0 0
0 0 0 0 0 0 0 0 0 0 0
0 0 0 0 0 0 0 0 0 0 0
0 0 0 0 0 0 0 0 0 0 0
0 0 0 0 0 0 0 0 0 0 0
0 0 0 0 0 0 0 0 0 0 0
0 0 0 0 0 0 0 0 0 0 0
0 0 0 0 0 0 0 0 0 0 0
0 0 0 0 0 0 0 0 0 0 0
0 0 0 0 0 0 0 0 0 0 0
0 0 0 0 0 0 0 0 0 0 0
0 0 0 0 0 0 0 0 0 0 0
0 0 0 0 0 0 0 0 0 0 0
0 0 0 0 0 0 0 0 0 0 0
0 0 0 0 0 0 0 0 0 0 0
0 0 0 0 0 0 0 0 0 0 0
0 0 0 0 0 0 0 0 0 0 0
0 0 0 0 0 0 0 0 0 0 0
0 0 0 0 0 0 0 0 0 0 0
0 0 0 0 0 0 0 0 0 0 0
0 0 0 0 0 0 0 0 0 0 0
0 0 0 0 0 0 0 0 0 0 0
0 0 0 0 0 0 0 0 0 0 0
0 0 0 0 0 0 0 0 0 0 0
0 0 0 0 0 0 0 0 0 0 0
0 0 0 0 0 0 0 0 0 0 0
0 0 0 0 0 0 0 0 0 0 0
0 0 0 0 0 0 0 0 0 0 0
0 0 0 0 0 0 0 0 0 0 0
0 0 0 0 0 0 0 0 0 0 0
0 0 0 0 0 0 0 0 0 0 0
0 0 0 0 0 0 0 0 0 0 0
0 0 0 0 0 0 0 0 0 0 0
0 0 0 0 0 0 0 0 0 0 0
0 0 0 0 0 0 0 0 0 0 0
0 0 0 0 0 0 0 0 0 0 0
0 0 0 0 0 0 0 0 0 0 0
0 0 0 0 0 0 0 0 0 0 0
0 0 0 0 0 0 0 0 0 0 0
0 0 0 0 0 0 0 0 0 0 0
0 0 0 0 0 0 0 0 0 0 0
0 0 0 0 0 0 0 0 0 0 0
0 0 0 0 0 0 0 0 0 0 0
0 0 0 0 0 0 0 0 0 0 0
0 0 0 0 0 0 0 0 0 0 0
0 0 0 0 0 0 0 0 0 0 0
0 0 0 0 0 0 0 0 0 0 0
0 0 0 0 0 0 0 0 0 0 0
0 0 0 0 0 0 0 0 0 0 0
0 0 0 0 0 0 0 0 0 0 0