MODE 2
SIZE 11/70
LIMIT 0/1000
COLOR LIMIT 5
STARS 900/2100/3550
POWERUPS 1/0/0/0
30 7 30 7 7 7 7 30 7 7 12
30 7 14 14 7 30 30 30 7 7 30
30 7 7 14 7 30 30 14 30 7 30
30 7 14 14 7 7 14 14 7 7 27
30 7 35 30 7 11 7 14 7 7 30
30 11 30 7 35 30 30 7 7 30 30
27 7 7 14 7 7 30 30 11 7 30
30 7 14 14 7 27 7 7 7 30 30
30 7 7 14 7 7 7 14 14 35 30
30 11 30 30 30 7 7 14 7 30 30
30 35 7 7 11 7 7 14 14 20 30
0 7 0 0 0 30 0 0 27 27 0
0 0 7 11 0 30 30 7 29 35 27
0 30 7 20 11 0 7 7 29 27 7
0 30 30 29 29 7 0 7 7 7 7
0 27 27 35 29 7 0 7 7 7 7
0 0 27 27 7 7 0 7 7 35 7
0 20 7 7 7 0 7 7 7 7 0
0 7 7 0 0 0 0 7 7 7 7
7 35 7 7 0 20 20 0 30 30 0
0 7 7 7 0 20 20 0 30 30 0
0 0 0 0 0 0 0 0 0 0 0
0 0 0 0 0 0 0 0 0 0 0
0 0 0 0 0 0 0 0 0 0 0
0 0 0 0 0 0 0 0 0 0 0
0 0 0 0 0 0 0 0 0 0 0
0 0 0 0 0 0 0 0 0 0 0
0 0 0 0 0 0 0 0 0 0 0
0 0 0 0 0 0 0 0 0 0 0
0 0 0 0 0 0 0 0 0 0 0
0 0 0 0 0 0 0 0 0 0 0
0 0 0 0 0 0 0 0 0 0 0
0 0 0 0 0 0 0 0 0 0 0
0 0 0 0 0 0 0 0 0 0 0
0 0 0 0 0 0 0 0 0 0 0
0 0 0 0 0 0 0 0 0 0 0
0 0 0 0 0 0 0 0 0 0 0
0 0 0 0 0 0 0 0 0 0 0
0 0 0 0 0 0 0 0 0 0 0
0 0 0 0 0 0 0 0 0 0 0
0 0 0 0 0 0 0 0 0 0 0
0 0 0 0 0 0 0 0 0 0 0
0 0 0 0 0 0 0 0 0 0 0
0 0 0 0 0 0 0 0 0 0 0
0 0 0 0 0 0 0 0 0 0 0
0 0 0 0 0 0 0 0 0 0 0
0 0 0 0 0 0 0 0 0 0 0
0 0 0 0 0 0 0 0 0 0 0
0 0 0 0 0 0 0 0 0 0 0
0 0 0 0 0 0 0 0 0 0 0
0 0 0 0 0 0 0 0 0 0 0
0 0 0 0 0 0 0 0 0 0 0
0 0 0 0 0 0 0 0 0 0 0
0 0 0 0 0 0 0 0 0 0 0
0 0 0 0 0 0 0 0 0 0 0
0 0 0 0 0 0 0 0 0 0 0
0 0 0 0 0 0 0 0 0 0 0
0 0 0 0 0 0 0 0 0 0 0
0 0 0 0 0 0 0 0 0 0 0
0 0 0 0 0 0 0 0 0 0 0
0 0 0 0 0 0 0 0 0 0 0
0 0 0 0 0 0 0 0 0 0 0
0 0 0 0 0 0 0 0 0 0 0
0 0 0 0 0 0 0 0 0 0 0
0 0 0 0 0 0 0 0 0 0 0
0 0 0 0 0 0 0 0 0 0 0
0 0 0 0 0 0 0 0 0 0 0
0 0 0 0 0 0 0 0 0 0 0
0 0 0 0 0 0 0 0 0 0 0
0 0 0 0 0 0 0 0 0 0 0