MODE 2
SIZE 11/70
LIMIT 0/1000
COLOR LIMIT 4
STARS 500/1500/4600
POWERUPS 1/0/0/0
7 7 7 7 7 7 7 7 7 7 7
0 7 30 7 7 11 7 7 7 0 0
0 0 7 0 7 7 7 0 7 0 0
0 35 7 7 7 35 30 7 7 0 0
0 7 7 7 0 11 0 7 7 35 0
0 7 7 7 35 7 7 35 0 0 0
0 0 7 24 7 7 7 12 7 0 0
0 7 0 29 7 23 29 0 7 0 0
0 7 7 7 7 16 7 7 7 7 0
0 7 0 0 35 7 32 0 7 0 0
0 0 7 30 7 7 35 7 27 0 0
0 7 35 7 7 0 7 7 7 0 0
0 7 7 7 30 30 7 7 7 7 0
7 7 7 7 30 30 7 7 7 7 0
7 7 7 32 7 7 7 0 7 7 0
0 7 7 0 35 7 0 7 7 0 0
7 7 0 7 7 12 7 7 0 7 7
7 0 0 30 7 7 5 0 0 7 0
0 7 7 7 30 23 35 7 7 7 0
0 7 7 7 7 7 7 5 7 0 0
0 0 7 7 7 7 7 7 7 0 0
0 0 0 0 0 0 0 0 0 0 0
0 0 0 0 0 0 0 0 0 0 0
0 0 0 0 0 0 0 0 0 0 0
0 0 0 0 0 0 0 0 0 0 0
0 0 0 0 0 0 0 0 0 0 0
0 0 0 0 0 0 0 0 0 0 0
0 0 0 0 0 0 0 0 0 0 0
0 0 0 0 0 0 0 0 0 0 0
0 0 0 0 0 0 0 0 0 0 0
0 0 0 0 0 0 0 0 0 0 0
0 0 0 0 0 0 0 0 0 0 0
0 0 0 0 0 0 0 0 0 0 0
0 0 0 0 0 0 0 0 0 0 0
0 0 0 0 0 0 0 0 0 0 0
0 0 0 0 0 0 0 0 0 0 0
0 0 0 0 0 0 0 0 0 0 0
0 0 0 0 0 0 0 0 0 0 0
0 0 0 0 0 0 0 0 0 0 0
0 0 0 0 0 0 0 0 0 0 0
0 0 0 0 0 0 0 0 0 0 0
0 0 0 0 0 0 0 0 0 0 0
0 0 0 0 0 0 0 0 0 0 0
0 0 0 0 0 0 0 0 0 0 0
0 0 0 0 0 0 0 0 0 0 0
0 0 0 0 0 0 0 0 0 0 0
0 0 0 0 0 0 0 0 0 0 0
0 0 0 0 0 0 0 0 0 0 0
0 0 0 0 0 0 0 0 0 0 0
0 0 0 0 0 0 0 0 0 0 0
0 0 0 0 0 0 0 0 0 0 0
0 0 0 0 0 0 0 0 0 0 0
0 0 0 0 0 0 0 0 0 0 0
0 0 0 0 0 0 0 0 0 0 0
0 0 0 0 0 0 0 0 0 0 0
0 0 0 0 0 0 0 0 0 0 0
0 0 0 0 0 0 0 0 0 0 0
0 0 0 0 0 0 0 0 0 0 0
0 0 0 0 0 0 0 0 0 0 0
0 0 0 0 0 0 0 0 0 0 0
0 0 0 0 0 0 0 0 0 0 0
0 0 0 0 0 0 0 0 0 0 0
0 0 0 0 0 0 0 0 0 0 0
0 0 0 0 0 0 0 0 0 0 0
0 0 0 0 0 0 0 0 0 0 0
0 0 0 0 0 0 0 0 0 0 0
0 0 0 0 0 0 0 0 0 0 0
0 0 0 0 0 0 0 0 0 0 0
0 0 0 0 0 0 0 0 0 0 0
0 0 0 0 0 0 0 0 0 0 0