MODE 2
SIZE 11/70
LIMIT 0/1000
COLOR LIMIT 5
STARS 500/2900/5000
POWERUPS 1/0/0/0
17 17 7 7 31 31 31 7 7 7 18
7 7 7 35 7 23 7 35 7 18 30
17 11 7 20 7 23 23 7 7 7 18
7 7 20 20 7 7 35 31 7 18 30
17 12 7 31 31 7 7 31 31 7 18
5 5 7 31 35 7 7 26 7 18 30
17 15 7 7 11 7 7 26 26 7 18
7 7 35 11 11 7 35 7 7 18 30
30 29 30 29 30 29 30 29 30 29 30
7 7 0 0 0 0 0 0 30 0 0
0 30 30 35 0 7 7 7 0 30 0
7 30 7 7 7 11 7 7 30 7 0
0 30 0 7 7 11 11 0 0 30 7
29 29 7 35 7 0 7 7 7 26 0
7 29 0 7 0 0 7 0 7 26 26
7 29 7 7 7 31 0 30 0 7 7
0 7 0 11 7 31 31 30 7 7 29
0 30 11 11 7 7 7 30 0 29 7
0 30 7 7 7 0 35 0 30 0 29
30 30 7 0 7 7 7 0 26 7 0
0 0 0 0 0 0 0 0 0 0 0
0 0 0 0 0 0 0 0 0 0 0
0 0 0 0 0 0 0 0 0 0 0
0 0 0 0 0 0 0 0 0 0 0
0 0 0 0 0 0 0 0 0 0 0
0 0 0 0 0 0 0 0 0 0 0
0 0 0 0 0 0 0 0 0 0 0
0 0 0 0 0 0 0 0 0 0 0
0 0 0 0 0 0 0 0 0 0 0
0 0 0 0 0 0 0 0 0 0 0
0 0 0 0 0 0 0 0 0 0 0
0 0 0 0 0 0 0 0 0 0 0
0 0 0 0 0 0 0 0 0 0 0
0 0 0 0 0 0 0 0 0 0 0
0 0 0 0 0 0 0 0 0 0 0
0 0 0 0 0 0 0 0 0 0 0
0 0 0 0 0 0 0 0 0 0 0
0 0 0 0 0 0 0 0 0 0 0
0 0 0 0 0 0 0 0 0 0 0
0 0 0 0 0 0 0 0 0 0 0
0 0 0 0 0 0 0 0 0 0 0
0 0 0 0 0 0 0 0 0 0 0
0 0 0 0 0 0 0 0 0 0 0
0 0 0 0 0 0 0 0 0 0 0
0 0 0 0 0 0 0 0 0 0 0
0 0 0 0 0 0 0 0 0 0 0
0 0 0 0 0 0 0 0 0 0 0
0 0 0 0 0 0 0 0 0 0 0
0 0 0 0 0 0 0 0 0 0 0
0 0 0 0 0 0 0 0 0 0 0
0 0 0 0 0 0 0 0 0 0 0
0 0 0 0 0 0 0 0 0 0 0
0 0 0 0 0 0 0 0 0 0 0
0 0 0 0 0 0 0 0 0 0 0
0 0 0 0 0 0 0 0 0 0 0
0 0 0 0 0 0 0 0 0 0 0
0 0 0 0 0 0 0 0 0 0 0
0 0 0 0 0 0 0 0 0 0 0
0 0 0 0 0 0 0 0 0 0 0
0 0 0 0 0 0 0 0 0 0 0
0 0 0 0 0 0 0 0 0 0 0
0 0 0 0 0 0 0 0 0 0 0
0 0 0 0 0 0 0 0 0 0 0
0 0 0 0 0 0 0 0 0 0 0
0 0 0 0 0 0 0 0 0 0 0
0 0 0 0 0 0 0 0 0 0 0
0 0 0 0 0 0 0 0 0 0 0
0 0 0 0 0 0 0 0 0 0 0
0 0 0 0 0 0 0 0 0 0 0
0 0 0 0 0 0 0 0 0 0 0