MODE 2
SIZE 11/70
LIMIT 0/1000
COLOR LIMIT 4
STARS 500/2500/4600
POWERUPS 1/0/0/0
7 7 7 7 7 7 7 22 11 11 22
7 30 30 23 23 23 23 2 11 22 7
0 7 7 30 7 21 2 7 6 7 7
0 7 35 7 25 7 7 7 7 7 0
0 0 7 7 7 12 7 35 7 7 0
0 0 32 7 30 7 32 7 7 0 0
0 0 0 15 7 30 15 1 7 0 0
0 0 32 12 7 32 32 32 7 0 0
0 0 0 32 1 7 7 7 17 0 0
0 0 0 7 30 7 7 32 0 0 0
0 0 0 0 7 30 7 15 0 0 0
0 0 12 7 7 7 7 32 0 0 0
0 0 0 7 7 35 7 7 32 0 0
0 0 32 7 7 35 7 7 32 0 0
0 0 15 7 7 7 7 7 7 0 0
0 0 32 7 5 5 30 30 5 0 0
0 0 0 32 7 7 30 30 7 15 0
0 0 7 7 7 7 17 7 32 0 0
0 0 30 30 22 7 7 7 32 0 0
0 0 30 7 7 7 7 7 32 0 0
0 0 7 7 7 7 7 30 30 7 0
0 0 0 0 0 0 0 0 0 0 0
0 0 0 0 0 0 0 0 0 0 0
0 0 0 0 0 0 0 0 0 0 0
0 0 0 0 0 0 0 0 0 0 0
0 0 0 0 0 0 0 0 0 0 0
0 0 0 0 0 0 0 0 0 0 0
0 0 0 0 0 0 0 0 0 0 0
0 0 0 0 0 0 0 0 0 0 0
0 0 0 0 0 0 0 0 0 0 0
0 0 0 0 0 0 0 0 0 0 0
0 0 0 0 0 0 0 0 0 0 0
0 0 0 0 0 0 0 0 0 0 0
0 0 0 0 0 0 0 0 0 0 0
0 0 0 0 0 0 0 0 0 0 0
0 0 0 0 0 0 0 0 0 0 0
0 0 0 0 0 0 0 0 0 0 0
0 0 0 0 0 0 0 0 0 0 0
0 0 0 0 0 0 0 0 0 0 0
0 0 0 0 0 0 0 0 0 0 0
0 0 0 0 0 0 0 0 0 0 0
0 0 0 0 0 0 0 0 0 0 0
0 0 0 0 0 0 0 0 0 0 0
0 0 0 0 0 0 0 0 0 0 0
0 0 0 0 0 0 0 0 0 0 0
0 0 0 0 0 0 0 0 0 0 0
0 0 0 0 0 0 0 0 0 0 0
0 0 0 0 0 0 0 0 0 0 0
0 0 0 0 0 0 0 0 0 0 0
0 0 0 0 0 0 0 0 0 0 0
0 0 0 0 0 0 0 0 0 0 0
0 0 0 0 0 0 0 0 0 0 0
0 0 0 0 0 0 0 0 0 0 0
0 0 0 0 0 0 0 0 0 0 0
0 0 0 0 0 0 0 0 0 0 0
0 0 0 0 0 0 0 0 0 0 0
0 0 0 0 0 0 0 0 0 0 0
0 0 0 0 0 0 0 0 0 0 0
0 0 0 0 0 0 0 0 0 0 0
0 0 0 0 0 0 0 0 0 0 0
0 0 0 0 0 0 0 0 0 0 0
0 0 0 0 0 0 0 0 0 0 0
0 0 0 0 0 0 0 0 0 0 0
0 0 0 0 0 0 0 0 0 0 0
0 0 0 0 0 0 0 0 0 0 0
0 0 0 0 0 0 0 0 0 0 0
0 0 0 0 0 0 0 0 0 0 0
0 0 0 0 0 0 0 0 0 0 0
0 0 0 0 0 0 0 0 0 0 0
0 0 0 0 0 0 0 0 0 0 0