MODE 2
SIZE 11/70
LIMIT 0/1000
COLOR LIMIT 4
STARS 1000/2000/3000
POWERUPS 1/0/0/0
7 7 7 7 7 7 7 7 7 7 7
7 13 7 7 7 14 7 7 7 7 7
0 7 7 35 0 7 30 35 0 7 7
7 12 7 0 7 7 7 35 7 7 7
0 7 7 30 7 7 7 7 7 7 7
7 7 7 7 7 11 7 7 7 7 7
7 7 7 35 0 7 7 0 7 7 7
0 7 7 0 7 7 7 7 7 0 0
0 7 14 7 7 7 30 30 7 7 0
0 7 7 0 7 24 35 7 7 0 0
7 7 7 7 7 18 7 7 7 7 0
7 30 35 7 0 7 7 7 7 0 0
0 16 7 7 7 17 7 7 7 0 0
0 7 7 7 7 7 7 24 7 0 0
0 0 7 7 7 7 7 7 7 7 0
0 7 24 30 7 7 7 24 7 0 0
0 0 7 7 7 7 7 7 7 7 0
0 7 7 7 7 7 16 7 7 7 0
0 0 7 7 7 7 7 7 7 7 7
0 7 7 7 7 7 7 24 7 7 0
0 0 0 0 0 0 0 0 0 0 0
0 0 0 0 0 0 0 0 0 0 0
0 0 0 0 0 0 0 0 0 0 0
0 0 0 0 0 0 0 0 0 0 0
0 0 0 0 0 0 0 0 0 0 0
0 0 0 0 0 0 0 0 0 0 0
0 0 0 0 0 0 0 0 0 0 0
0 0 0 0 0 0 0 0 0 0 0
0 0 0 0 0 0 0 0 0 0 0
0 0 0 0 0 0 0 0 0 0 0
0 0 0 0 0 0 0 0 0 0 0
0 0 0 0 0 0 0 0 0 0 0
0 0 0 0 0 0 0 0 0 0 0
0 0 0 0 0 0 0 0 0 0 0
0 0 0 0 0 0 0 0 0 0 0
0 0 0 0 0 0 0 0 0 0 0
0 0 0 0 0 0 0 0 0 0 0
0 0 0 0 0 0 0 0 0 0 0
0 0 0 0 0 0 0 0 0 0 0
0 0 0 0 0 0 0 0 0 0 0
0 0 0 0 0 0 0 0 0 0 0
0 0 0 0 0 0 0 0 0 0 0
0 0 0 0 0 0 0 0 0 0 0
0 0 0 0 0 0 0 0 0 0 0
0 0 0 0 0 0 0 0 0 0 0
0 0 0 0 0 0 0 0 0 0 0
0 0 0 0 0 0 0 0 0 0 0
0 0 0 0 0 0 0 0 0 0 0
0 0 0 0 0 0 0 0 0 0 0
0 0 0 0 0 0 0 0 0 0 0
0 0 0 0 0 0 0 0 0 0 0
0 0 0 0 0 0 0 0 0 0 0
0 0 0 0 0 0 0 0 0 0 0
0 0 0 0 0 0 0 0 0 0 0
0 0 0 0 0 0 0 0 0 0 0
0 0 0 0 0 0 0 0 0 0 0
0 0 0 0 0 0 0 0 0 0 0
0 0 0 0 0 0 0 0 0 0 0
0 0 0 0 0 0 0 0 0 0 0
0 0 0 0 0 0 0 0 0 0 0
0 0 0 0 0 0 0 0 0 0 0
0 0 0 0 0 0 0 0 0 0 0
0 0 0 0 0 0 0 0 0 0 0
0 0 0 0 0 0 0 0 0 0 0
0 0 0 0 0 0 0 0 0 0 0
0 0 0 0 0 0 0 0 0 0 0
0 0 0 0 0 0 0 0 0 0 0
0 0 0 0 0 0 0 0 0 0 0
0 0 0 0 0 0 0 0 0 0 0
0 0 0 0 0 0 0 0 0 0 0