MODE 2
SIZE 11/70
LIMIT 0/1000
COLOR LIMIT 3
STARS 1000/4300/6900
POWERUPS 1/0/0/0
0 13 7 7 7 7 14 7 7 7 7
0 7 7 7 7 23 7 7 23 7 0
0 7 35 7 7 30 30 7 7 7 0
0 7 7 7 26 7 7 7 7 7 0
0 18 7 7 30 30 30 7 30 7 0
0 7 7 7 35 7 7 7 7 7 0
0 7 7 7 35 35 7 7 7 7 0
0 7 7 7 30 7 7 11 7 7 0
0 7 7 11 7 35 7 7 7 7 0
0 7 7 7 7 7 7 7 7 30 0
0 7 7 7 7 7 7 7 1 7 0
0 7 7 7 7 35 7 7 11 0 0
0 0 7 7 7 7 7 7 7 7 0
0 7 7 35 7 7 7 7 7 0 0
0 0 7 7 7 14 7 7 7 0 0
0 7 30 7 7 7 7 7 7 0 0
0 7 7 7 7 7 7 7 30 7 0
0 7 7 7 14 7 0 0 7 0 0
0 0 7 7 7 7 7 7 7 0 0
0 0 0 7 7 7 7 0 0 0 0
0 0 0 0 0 0 0 0 0 0 0
0 0 0 0 0 0 0 0 0 0 0
0 0 0 0 0 0 0 0 0 0 0
0 0 0 0 0 0 0 0 0 0 0
0 0 0 0 0 0 0 0 0 0 0
0 0 0 0 0 0 0 0 0 0 0
0 0 0 0 0 0 0 0 0 0 0
0 0 0 0 0 0 0 0 0 0 0
0 0 0 0 0 0 0 0 0 0 0
0 0 0 0 0 0 0 0 0 0 0
0 0 0 0 0 0 0 0 0 0 0
0 0 0 0 0 0 0 0 0 0 0
0 0 0 0 0 0 0 0 0 0 0
0 0 0 0 0 0 0 0 0 0 0
0 0 0 0 0 0 0 0 0 0 0
0 0 0 0 0 0 0 0 0 0 0
0 0 0 0 0 0 0 0 0 0 0
0 0 0 0 0 0 0 0 0 0 0
0 0 0 0 0 0 0 0 0 0 0
0 0 0 0 0 0 0 0 0 0 0
0 0 0 0 0 0 0 0 0 0 0
0 0 0 0 0 0 0 0 0 0 0
0 0 0 0 0 0 0 0 0 0 0
0 0 0 0 0 0 0 0 0 0 0
0 0 0 0 0 0 0 0 0 0 0
0 0 0 0 0 0 0 0 0 0 0
0 0 0 0 0 0 0 0 0 0 0
0 0 0 0 0 0 0 0 0 0 0
0 0 0 0 0 0 0 0 0 0 0
0 0 0 0 0 0 0 0 0 0 0
0 0 0 0 0 0 0 0 0 0 0
0 0 0 0 0 0 0 0 0 0 0
0 0 0 0 0 0 0 0 0 0 0
0 0 0 0 0 0 0 0 0 0 0
0 0 0 0 0 0 0 0 0 0 0
0 0 0 0 0 0 0 0 0 0 0
0 0 0 0 0 0 0 0 0 0 0
0 0 0 0 0 0 0 0 0 0 0
0 0 0 0 0 0 0 0 0 0 0
0 0 0 0 0 0 0 0 0 0 0
0 0 0 0 0 0 0 0 0 0 0
0 0 0 0 0 0 0 0 0 0 0
0 0 0 0 0 0 0 0 0 0 0
0 0 0 0 0 0 0 0 0 0 0
0 0 0 0 0 0 0 0 0 0 0
0 0 0 0 0 0 0 0 0 0 0
0 0 0 0 0 0 0 0 0 0 0
0 0 0 0 0 0 0 0 0 0 0
0 0 0 0 0 0 0 0 0 0 0
0 0 0 0 0 0 0 0 0 0 0