MODE 2
SIZE 11/70
LIMIT 0/1000
COLOR LIMIT 5
STARS 1200/5600/9600
POWERUPS 1/0/0/0
7 7 7 7 7 7 13 7 7 7 7
7 7 7 7 0 7 0 7 7 11 1
11 7 7 7 7 35 35 7 7 7 30
7 7 7 30 7 7 7 7 7 30 7
7 30 7 7 30 7 27 14 7 7 30
7 7 30 7 32 7 7 7 7 7 7
7 7 32 32 7 7 7 7 32 7 7
12 7 14 0 35 35 0 27 7 7 7
7 7 7 30 7 0 30 30 7 30 7
7 20 35 30 7 0 30 7 7 7 7
7 7 0 30 7 30 0 7 7 32 12
7 30 30 7 7 7 7 7 7 15 7
0 0 30 7 7 7 7 32 7 0 0
0 32 32 7 7 7 32 7 7 0 0
0 7 7 7 11 7 32 7 7 0 0
0 0 7 7 0 0 30 7 0 0 0
0 0 7 7 7 12 7 30 7 20 0
0 0 7 7 7 7 7 7 7 0 0
0 7 30 7 27 0 0 7 7 0 0
0 7 7 7 7 7 7 7 7 0 0
0 0 0 0 0 0 0 0 0 0 0
0 0 0 0 0 0 0 0 0 0 0
0 0 0 0 0 0 0 0 0 0 0
0 0 0 0 0 0 0 0 0 0 0
0 0 0 0 0 0 0 0 0 0 0
0 0 0 0 0 0 0 0 0 0 0
0 0 0 0 0 0 0 0 0 0 0
0 0 0 0 0 0 0 0 0 0 0
0 0 0 0 0 0 0 0 0 0 0
0 0 0 0 0 0 0 0 0 0 0
0 0 0 0 0 0 0 0 0 0 0
0 0 0 0 0 0 0 0 0 0 0
0 0 0 0 0 0 0 0 0 0 0
0 0 0 0 0 0 0 0 0 0 0
0 0 0 0 0 0 0 0 0 0 0
0 0 0 0 0 0 0 0 0 0 0
0 0 0 0 0 0 0 0 0 0 0
0 0 0 0 0 0 0 0 0 0 0
0 0 0 0 0 0 0 0 0 0 0
0 0 0 0 0 0 0 0 0 0 0
0 0 0 0 0 0 0 0 0 0 0
0 0 0 0 0 0 0 0 0 0 0
0 0 0 0 0 0 0 0 0 0 0
0 0 0 0 0 0 0 0 0 0 0
0 0 0 0 0 0 0 0 0 0 0
0 0 0 0 0 0 0 0 0 0 0
0 0 0 0 0 0 0 0 0 0 0
0 0 0 0 0 0 0 0 0 0 0
0 0 0 0 0 0 0 0 0 0 0
0 0 0 0 0 0 0 0 0 0 0
0 0 0 0 0 0 0 0 0 0 0
0 0 0 0 0 0 0 0 0 0 0
0 0 0 0 0 0 0 0 0 0 0
0 0 0 0 0 0 0 0 0 0 0
0 0 0 0 0 0 0 0 0 0 0
0 0 0 0 0 0 0 0 0 0 0
0 0 0 0 0 0 0 0 0 0 0
0 0 0 0 0 0 0 0 0 0 0
0 0 0 0 0 0 0 0 0 0 0
0 0 0 0 0 0 0 0 0 0 0
0 0 0 0 0 0 0 0 0 0 0
0 0 0 0 0 0 0 0 0 0 0
0 0 0 0 0 0 0 0 0 0 0
0 0 0 0 0 0 0 0 0 0 0
0 0 0 0 0 0 0 0 0 0 0
0 0 0 0 0 0 0 0 0 0 0
0 0 0 0 0 0 0 0 0 0 0
0 0 0 0 0 0 0 0 0 0 0
0 0 0 0 0 0 0 0 0 0 0
0 0 0 0 0 0 0 0 0 0 0