MODE 2
SIZE 11/70
LIMIT 0/1000
COLOR LIMIT 3
STARS 1300/5600/7500
POWERUPS 1/0/0/0
0 7 7 7 7 7 7 7 7 7 0
0 12 7 7 35 35 7 7 15 0 0
0 0 7 7 0 11 7 7 7 0 0
0 7 7 0 0 7 7 7 7 7 0
0 7 7 0 32 7 7 15 0 7 0
0 7 7 7 35 35 7 0 7 7 0
0 0 7 7 7 35 23 7 0 7 0
0 0 7 7 32 7 7 0 7 0 0
0 0 7 7 30 26 7 7 7 7 0
0 0 7 35 13 0 30 35 7 0 0
0 0 7 7 7 0 7 7 7 7 0
0 0 23 7 7 7 14 7 7 0 0
0 0 0 7 0 32 7 7 7 0 0
0 0 7 0 0 7 7 7 0 0 0
0 0 0 7 30 23 7 26 7 0 0
0 0 0 30 30 30 30 30 7 0 0
0 0 0 0 7 7 7 0 7 7 0
0 0 0 7 7 0 0 0 7 7 0
0 0 0 27 7 30 7 7 7 7 7
0 0 7 7 7 7 7 7 7 7 7
0 0 0 0 0 0 0 0 0 0 0
0 0 0 0 0 0 0 0 0 0 0
0 0 0 0 0 0 0 0 0 0 0
0 0 0 0 0 0 0 0 0 0 0
0 0 0 0 0 0 0 0 0 0 0
0 0 0 0 0 0 0 0 0 0 0
0 0 0 0 0 0 0 0 0 0 0
0 0 0 0 0 0 0 0 0 0 0
0 0 0 0 0 0 0 0 0 0 0
0 0 0 0 0 0 0 0 0 0 0
0 0 0 0 0 0 0 0 0 0 0
0 0 0 0 0 0 0 0 0 0 0
0 0 0 0 0 0 0 0 0 0 0
0 0 0 0 0 0 0 0 0 0 0
0 0 0 0 0 0 0 0 0 0 0
0 0 0 0 0 0 0 0 0 0 0
0 0 0 0 0 0 0 0 0 0 0
0 0 0 0 0 0 0 0 0 0 0
0 0 0 0 0 0 0 0 0 0 0
0 0 0 0 0 0 0 0 0 0 0
0 0 0 0 0 0 0 0 0 0 0
0 0 0 0 0 0 0 0 0 0 0
0 0 0 0 0 0 0 0 0 0 0
0 0 0 0 0 0 0 0 0 0 0
0 0 0 0 0 0 0 0 0 0 0
0 0 0 0 0 0 0 0 0 0 0
0 0 0 0 0 0 0 0 0 0 0
0 0 0 0 0 0 0 0 0 0 0
0 0 0 0 0 0 0 0 0 0 0
0 0 0 0 0 0 0 0 0 0 0
0 0 0 0 0 0 0 0 0 0 0
0 0 0 0 0 0 0 0 0 0 0
0 0 0 0 0 0 0 0 0 0 0
0 0 0 0 0 0 0 0 0 0 0
0 0 0 0 0 0 0 0 0 0 0
0 0 0 0 0 0 0 0 0 0 0
0 0 0 0 0 0 0 0 0 0 0
0 0 0 0 0 0 0 0 0 0 0
0 0 0 0 0 0 0 0 0 0 0
0 0 0 0 0 0 0 0 0 0 0
0 0 0 0 0 0 0 0 0 0 0
0 0 0 0 0 0 0 0 0 0 0
0 0 0 0 0 0 0 0 0 0 0
0 0 0 0 0 0 0 0 0 0 0
0 0 0 0 0 0 0 0 0 0 0
0 0 0 0 0 0 0 0 0 0 0
0 0 0 0 0 0 0 0 0 0 0
0 0 0 0 0 0 0 0 0 0 0
0 0 0 0 0 0 0 0 0 0 0
0 0 0 0 0 0 0 0 0 0 0